-------------------------
*&                      -
--                      -
-  --                  !-
-                 -------
-         &             -
-        -----          -
-                       -
--                      -
-                       -
-                      &-
-      ---          -----
-                       -
-                 &     -
-                --     -
-&                      -
------                  -
-                       -
- @         &           -
-------------------------