-------------------------
-                      @-
-                   -----
-                       -
-            --         -
- &                    &-
---                  ----
-                      !-
-                   -----
-                       -
-                --     -
-     ----              -
-    &                 -
-   ----------          -
-                       -
-                -  &   -
-                   -   -
-----                   -
*  &              &     -
-------------------------